000000000000000000000000000000
000000000000000000000000000000
000000111100000000001111000000
000000100000000000000001000000
000000100000000000000001000000
000000000000000000000000000000
000000000000000000000000000000
000000000001100001100000000000
000000000011110011100000000000
000000000011111111100000000000
000000000000111110000000000000
000000000000011100000000000000
000000000000001000000000000000
000000100000000000000001000000
000000100000000000000001000000
000000100000000000000001000000
000000111100000000001111000000
000000000000000000000000000000
000000000000000000000000000000
000000000000000000000000000000