000000000000000000000000000000
000000000000000000000000000000
000000111100000000001111000000
000000100000000000000001000000
000000100000000000000001000000
000000000000000000000000000000
000000000000000000000000000000
000000000000000000000000000000
000000000001111111100000000000
000000000000000000000000000000
000000000000000000000000000000
000000000000000000000000000000
000000000000000000000000000000
000000100000000000000001000000
000000100000000000000001000000
000000100000000000000001000000
000000111100000000001111000000
000000000000000000000000000000
000000000000000000000000000000
000000000000000000000000000000