000000000000000000000000000000
000000000000000000000000000000
000000111111000000111111000000
000000100000000000000001000000
000000100000000000000001000000
000000100000000000000001000000
000000100000001100000001000000
000000000000001100000000000000
000000000000001100000000000000
000000000000001100000000000000
000000000000001100000000000000
000000100000000000000001000000
000000100000000000000001000000
000000100000000000000001000000
000000100000000000000001000000
000000100000000000000001000000
000000111100000000001111000000
000000000000000000000000000000
000000000000000000000000000000
000000000000000000000000000000